1 2 3 4 5 6 7 8 9 10 22 
0 0 0 0 0 0 0 0 0 0 0 0 0 0 0 0 0 0 0
0 0 0 0 0 0 0 0 0 0 0 0 0 0 0 0 0 0 0
0 0 10 10 0 0 10 10 0 0 0 10 10 10 10 10 0 0 0
0 0 10 10 0 0 10 10 0 0 0 0 0 0 0 10 10 0 0
0 0 10 10 0 0 10 10 0 0 0 0 0 0 0 10 10 0 0
0 0 10 10 10 10 10 10 0 0 0 0 10 10 10 10 0 0 0
0 0 0 10 10 10 10 10 0 0 0 10 10 0 0 0 0 0 0
0 0 0 0 0 0 10 10 0 0 0 10 10 0 0 0 0 0 0
0 0 0 0 0 0 10 10 0 0 0 10 10 10 10 10 10 0 0
0 0 0 0 0 0 0 0 0 0 0 0 0 0 0 0 0 0 0
0 0 0 0 0 0 0 0 0 0 0 0 0 0 0 0 0 0 0
